1111111111
1000000001
1011110111
1001000101
1001000001
1011011111
1011000001
10m11111e1
1111111111