1111m1111
100000001
111101111
100000001
111101111
100000001
111101111
100000001
111101111
100000001
1111e1111