11111111111111
10000000000011
11100100001001
10001011e10011
1m001001100011
11111111111111